150 50
...............~~~~~~~~~~~~~~~~~~~~~~~~~~~~~~~~~~~~~~~~~~~~~~~~~~~~~~~~~~~~~~~~~~~~~~~~~~~~~~~~~~~~~~~~~~~~~~~~~~~~~~~~~~~~~~~~~~~~~~~~~~~~~~~~~~~~~~~
.......................................................................................................................#..................#..........~
........~~~~~~~~~..#~~~~~~~.~~~~~~~~~~~~.~~~~~~~~~~~~~~~~~~..~~~~~~~~~~~~~~~~~~~~~~~~..~~~~~~~~~~~~~~~~~~~~~~~~~~~..#..#..#..#....#########..........~
....~~~~~~~~~~~~#..~~~~~~~~.~~~~~~~~~~~~.~~~~~~~~~~~~~~~~~~..~~~~~~~~~~~~~~~~~~~~~~~~..~~~~~~~~~~~~~~~~~~~~~~~~~~~..#..#..#..#....#..............#...~
.........@@~~~~~~..#~~~~~~~.~~~~~~~~~~~~.....................~~~~~~~~~~~~~~~~~~~~~~~~..~~~~~~~~~~~~~~~~~~~~~~~~~~~..#..#.....#....############...#...~
..~~~~~~~@.........~~~~~~~~.~~~~~~~~~~~~.~~~~~~~~~~~~~~~~~~..~~~~~~~~~~~~~~~~~~~~~~~~..~~~~~~~~~~~~~~~~~~~~~~~~~~~..#..#..#..................#...#...~
..~~~~~~~.~~~~~~#..#~~~~~~~..............~~~~~~~~~~~~~~~~~~..~~~~~~~~~~~~~~~~~~~~~~~~..~~~~~~~~~~~~~~~~~~~~~~~~~~~..#..#..#..#...............#...#...~
~.~~~~~~~.~~~~~~~..~~~~~~~~~~~~~~...~~~~~~~~~~~~~~~~~~~~~~~..#~#~#~#~#~#~#~#~#~#~#~#~..~~~~~~~~~~~~~~~~~~~~~~~~~~~..#..#..#..####.########...#####...~
~.~~~~~~~.~~~~~~#..#~~~~~~~~~~~~~~..~~~~~......~~~~~~~~~~~~..................................................................#.......................~
~.........~~~~~~#..~~~~~~~~~~~~~~~..~~~~~......~~~~~~~~~~~~~.................................................................#.......................~
~.~~~~~~~~~~~~~~~..#~~~~~~~~~~~~~~~.~~~~~......~~~~~~~~~~~~~~~#~#~#~#~#~#~#~#~#~#~#~~~~~~~~~~~~~~..~~~~~...~~~..~~~~~~~~~~~~~~..~~~~~~~~~~~~~~~~~~~~~~
~.~~~~~~~~~~~~~~#..~~~~~~~~~~~~~~~~.~~~~~..~~~.~~~~~~~~~~~~~~~~~~~~~~~~~~~~~~~~~~~~~~~~~~~~~~~~~~..~~~~~...~~~..~~~~~~~~~~~~~~..~~~~~~~~~~~~~~~~~~~~~~
~.~~~~~~~~~~~~~....#~~~~~~~~~~~~~~~.~~~~~..~~~...~~~~~~~~~~~~~~~~~~~~~~~~~~~~~~~~~~~~~~~~~~~~~~~~~.~~~~~###~~~..~~~~~~~~~~~~~~..~~~~~~~~~~~~~~~~~~~~~~
~.~~~~~~~~~~~~~.#..~~~~~~~~~~~~~~~..~~~~~..~~~~~.~~~~~~~~~~~~~~~~~~~~~~~~~~~~~~~~~~~~~~~~~~~~~~~~~.~~~~~~~~~~~..~~~~~~~~~~~~~~..~~###############~~~~~
~...............#..#~~~~~~~~~~~~~...~~~~~..~~~~~............~~~~~~~~~~~~~~~~~~~~~~~~~~~~~~~~~~~~~~.~~~~~........~~~~~~~~~~~~~~..~~@@@@@@@@@@@@@@@~~~~~
~.~~~~~~~~~~~~~~#..~~~~~~~~~~~~~~...~~~~~..~~~...~~~~~~~~~~.~~~~~~~~~~~~~~~~~~~~~~~~~~~~~~~~~~~~~~.~~~~~.~~~~~..~~~~~~~~~~~~~~..~~~~.~~~~~~~~~.~~~~~~~
~.~~~~~~~~~~~~~~~..#~~~~~~~~~~~~~...~~~~~@@~~~.~~~~~~~~~~~~.~~~~~~~~~~~~~~~~~~~~~~~~~~~~~~~~~~~~~~.~~~~~.~~~~~..~~~~~~~~~~~~~~.......~~~~~~~~~.~~~~~~~
~.~~~~~~~~~~~~~~#.....~~~~~~~~~~~~..~~~~~~~~~~.~~~~~~~~~~~~.~~~~~~~~~~~~~~~~~~~~~~~~~~~~~~~....~~~#.............~~~~~~~~~~~~~~.......~~....~~~.~~~~~~~
~.~~~~~~~~~~~~~~~..#~...............~~~~~~~~~~.~~~~~~~~~~~~.~~~~~~~~~~~~~~~~~...................................~~~~~~~~~~~~~~~~~~~~.~~....~~~.~~~~~~~
~.~~~~~~~~~~~~~~#...................~~~~~~~~~~.~~~~~~~~~~~~~~~~~~~~~~~~~~~~~~.~~~~~~~~~~~~~.#~#~#~#~#~#~~~~~~~~~~~~~~~~~~~~~~~~~~~~~.~~....~~~.~~~~~~~
~.......~~~~~~~~##################..~~~~~~~~~~.~~~~~~~~~~~~@@@@@~~~~~~~~~~~~~.~~~~~~~~~~~~~............~~~~~~~~~~~~~~~~~~~~~~~~~~~~~...........~~~~~~~
~.~~.~~.~~~~~~~~~~~~~~~~~~~~~~~~~~..............................~~~~~~~~~~~~~.~~~~~~~~~~~~~............~~~~~~~~~~~~~~~~~~~~~~~~~~~~~.~~~~~~~~~.~~~~~~~
~.~~.~~.~~~~~~~~~~~~~~~~~~~~~~~~~~.....................................................................~~~~~~~~~~~~~~~~~~~~~~~~~~~~~.~~~~~~~~~.~~~~~~~
~.~~....~~~~~~~~~~~~~~~~~~~~~~~~~~~~~~~~~~~~~~~~~.~~~~~.~~~.....~~~~~~~~~~~~~~~~~~~~~~~~~~~~~~~~~~~~...~~~~~~~~~~~~~~~~~~~~~~~~~~~~~.~~~~~~~~~.~~~~~~~
~....~~~~~~~~~~~~~~~~~~~~~~~~~~~~~~~~~~~~~~~~~~~~.~~~~~.~~~.....~~~~~~~~~~~~~~~~~~~~~~~~~~~~~~~~~~~~...~~~~~~~~~~~~~~~~~~~~~~~~~~~~~.~~~~~~~~~.~~~~~~~
~.~~~~~~~~~~~~~~~~~~~~~~~~~~~~~~~~~~~~~~~~~~~~~~~.......~~~~~~~~~~~~~~~~~~~~~~~~~~~~~~~~~~~~~~~~~~~~...~~~~~~~~~~~~~~~~~~~~~~~~~~~~~...........~~~~~~~
~~~~~~~~~~~~~~~~~~~~~~~~~~..............~~~~~~~~~.~~~~~.~~~~~~~~~~~~~~~~~~~~~~~~~~~~~~~~~~~~~~~~~~~~...~~~~~~~~~~~~~~~~~~~~~~~~~~~~~.~~~~~~~~~.~~~~~~~
~~~~~~~~~~~~~~~~~~~~~~~~..............~~~~~~~~~~~.~~~~~.~~~~~~~~~~~~~~~~~~~~~~~~~~~~~~~~~~~~~~~~~~~~...~~~~~~~~~~~~~~~~~~~~~~~~~~~~~.~~~~~~~~~.~~~~~~~
~~~~~~~~~~~~~~~~~~~~~~~~~~~~...............~~~~~~.~~~~~.~~~~~~~~~~~~~~~~~~~~~~~~~~......~~~~~~~~~~~~...~~~~~~~~~~~~~~~~~~~~~~~~~~~~~.~~~~~~~~~.~~~~~~~
~~~~~~~~~~~~~~~~~~~~~~~~~............~~~~~~~~~~~~.~~~~~.~~~~~~~~~~~~~~~~~~~~~~~~~~.~~~~.~~~~~~~~~~~~...~~~~~~~~~~~~~~~~~~~~~~~~~~~~~.~~~~~~~~~.~~~~~~~
~~~~~~~~~~~~~~~~~~~~~~~~~~~~~~~........~~~~~~~~...........~~~~~~~~~~~~~~~~~~~~~~~~.~~~~.~~~~~~~~~~~~...~~~~~~~~~~~~~~~~~~~~~~~~~~~~~..~~~~~~~~.~~~~~~~
~~~~~~~~~~~~~~~~~~~~~~~~~~~~~~~~......~~~~~~~~~.~~~~~~~~~.~~~~~~~~~~~~~~~~~~~~~................................~~~~~~~~~~~~~~~~~~~~~..~~~~~~~..~~~~~~~
~~~~~~~~~~~~~~~~~~~~~~~~~~~~~~~~......~~~~~~~...............~~~~~~~~~~~~~~~~~~~.~~~~~~~~~~~~~~~~~~~~~~~~~~~~~~.~~~~~~~~~~~~~~~~~~~~~..~~~~~~~..~~~~~~~
~~~~~~~~~~~~~~~~~~~~~~~~~~~~~~~~......~~~~~~~.~~~~~~~~~~~~~.....................~~~~~~~~~~~~~~~~~~~~~~~~~~~~......~~~~~~~~~~~~~~~~~~...........~~~~~~~
~~~~~~~..............~~~~~~~~~~~......~~~~~~~.~~~~~~~~~~~~~.~~~~~~~~~~~~~~~~~~~.~~~~~~~~~~~~~~~~~~~~~~~~~~~~.~~~~.~~~~~~~~~~~~~~~~~~..~~~~~~~..~~~~~~~
~~~~~~~.........................................................................~~~~~~~~~~~~~~~~~~~~~~~~~~~~.~~~~.~~~~~~~~~~~~~.......~~~~~~~..~~~~~~~
~~~~~~~.~~~~~~~~~.~.~~~~~~.~~~~~~~~~~~~~~.~~~~~~~~~~.~~~~~~~~~.~~~~~.~~.~~~~~~~.................................................~~~~~~~~~~~~~~.~~~~~~~
~~~~~~~.~~~~~~~~~.~.~~~~~~................~~~~~~~~~~...........~~~~~.~~.~~~~~~~~~~~~~~~~~~~~~~.~~.~~~~~~~~~~~~~~~~~~~~~~~~~~~@@@@~~~~~~~~~~~~~.~~~~~~~
~~~~~~~.~~~~~~~~~.~.~~~~~~~~~~~.~~~~~~~~~~~~~~~~~~~~~~~~.~~~~~~~~~~~.~~.~~~~~~~~~~~~~~~~~~~~~~....~~~~~~~~~~~~~~~~~~~~~~~~~~~@~~@~~~~~~~~~~~~~.~~~~~~~
~~~~~~~.~~~~~~~~~.~.~~~~~~~~~~~..........................~~~~~~~~~~~.~~.~~~~~~~~~~~~~~~~~~~~~~~~~~~~~~~~~~~~~~~~~~~~~~~~~~~~~@~~@..............~~~~~~~
~~......~~~~~~~~~.~.~~~~~~~~~~~~~~~~~~~~~~~~~~~~~~~~~~~~~~~~~~~~~~~~.~~.~~~~~~~~~~~~~~~~~~~~~~~~~~~~~~~~~~~~~~~~~~~~~~~~~~~~~@@@@~~~~~~~~~~~~~~~~~~~~~
~.......@@~~~~~~~.~.~~~~~~~~~~~~~~~~~~~~~~~~~~~~~~~~~~~~~~~~~~~~~~~~.~~.~~~~~~~~~~~~~~~~~~~~~~~~~.....~~~~~~~~~~~~~~~~~~~~~~~.~~~~~~~~~~~~~~~~~~~~~~~~
...~~~..@@~~~~~~~...~~~~~~~~~~~~~~~~~~~~~~~~~~~~~~~~~~~~~~~~~~~~~~~~.~~.~~~~~~~~~~~~~~~~~~~~~~~~~.....~~~~~~~~~~~~~~~~~~~~~~~.~~~~~~~~~~~~~~~~~~~~~~~~
..~~~~~~~~~~~~~~~.~.~~~~~~~~~~~~~~~~~~~~~~~~~~~~~~~~~~~~~~~~~~~~~~~~.~~.~~~~~~~~~~~~~~~~~~~~~............~~~~~~~~~~~~~~~~~~~~.~~~~~~~~~~~~~~~~~~~~~~~~
..~~~~~~~~~~~~~~~.~.~~~~~~~~~~~~~~~~~~~~~~~~~~~~~~~~~~~~~~~~~~~~~~~~.@@.~~~~~~~~~~~~~~~~~~~~~............~~~~~~~~~~~~~~~~~~~~.~~~~~~~~~~~~~~~~~~~~~~~~
...~~~~~~~~~~~~~~.~.~~~~~~~~~~~~~~~~~~~~~~~~~~~~~~~~~~~~~~~~~~~~~~~~.@@.......................................................~~~~~~~~~~~~~~~~~~~~~~~~
.....~~~~~~~~~~~~.~.~~~~~~~~~~~~~~~~~~~~~~~~~~~~~~~~~~~~~~~~~~~~~~~~~~~~~~~~~~~~~~~~~~~~~~~~~~~~~~~~~~~~~~~~~~~~~~~~~~~~~~~~~~~~~~~~~~~~~~~~~~~~~~~~~~
.......~~~~~~~~~~.~.~~~~~~~~~~~~~~~~~~~~~~~~~~~~~~~~~~~~~~~~~~~~~~~~~~~~~~~~~~~~~~~~~~~~~~~~~~~~~~~~~~~~~~~~~~~~~~~~~~~~~~~~~~~~~~~~~~~~~~~~~~~~~~~~~~
....................~~~~~~~~~~~~~~~~~~~~~~~~~~~~~~~~~~~~~~~~~~~~~~~~~~~~~~~~~~~~~~~~~~~~~~~~~~~~~~~~~~~~~~~~~~~~~~~~~~~~~~~~~~~~~~~~~~~~~~~~~~~~~~~~~~
....................~~~~~~~~~~~~~~~~~~~~~~~~~~~~~~~~~~~~~~~~~~~~~~~~~~~~~~~~~~~~~~~~~~~~~~~~~~~~~~~~~~~~~~~~~~~~~~~~~~~~~~~~~~~~~~~~~~~~~~~~~~~~~~~~~~
