15 9
...............
....#.....#....
.....#...#.....
......#@#......
~~~....@....~~~
......#@#......
.....#...#.....
....#.....#....
...............
