15 9
...............
.######.######.
.#...........#.
.#...........#.
.......@.......
.#...........#.
.#...........#.
.######.######.
...............
