15 9
...............
.~~~~~~.~~~~~~.
.~...........~.
.~...........~.
.......@.......
.~...........~.
.~...........~.
.~~~~~~.~~~~~~.
...............
